2000000000
0000000000
0101111110
0100000010
0100000010
0100000010
0111111110
0000000000
0000000000
0000000000
